10 20
4 10
5
1 5 3
3 10 2
3 16 1
6 18 3
7 1 6
####################
#0000D.#S.0..#.0.0.#
#0000#.#0...0#..S..#
######.###D#####D###
#.........^.$......#
#$..........S......#
#.......##########D#
#D##....#..S......S#
#WW#....#....S.....#
####################