10 20
1 19
1
8 15 5 
####################
#$...0....0....0..^#
#.S#################
#.0............0..$#
#################S.#
#$.0..0..0..0..0...#
#.S#################
#........S.....#.WW#
#....S.........D.WW#
####################