10 20
1 1
2
4 15 3
4 16 3
####################
#^..0........#.....#
######.......#..W..#
#.........0..#.....#
#..0.........##DD###
#.........0.......$#
#..0.S.......0.....#
#$......S..........#
#..........S..0....#
####################